Parking	expenses:transport.car
Service & Parts	expenses:transport.car
Auto Payment	expenses:transport.car
Auto Insurance	expenses:transport.car
Public Transportation	expenses:transport.publictransport
Television	expenses:home.communications
Home Phone	expenses:home.communications
Internet	expenses:home.communications
Mobile Phone	expenses:home.communications
Utilities	expenses:home.utilities
Advertising	expenses:home.services
Office Supplies	expenses:home.services
Printing	expenses:home.services
Shipping	expenses:home.services
Legal	expenses:home.services
Tuition	
Student Loan	
Books & Supplies	expenses:shopping.books
Arts	expenses:entertainment.culture
Amusement	expenses:entertainment.culture
Music	expenses:entertainment.culture
Movies & DVDs	expenses:entertainment.culture
Newspapers & Magazines	expenses:entertainment.culture
Service Fee	expenses:home.incurences-fees
Late Fee	expenses:home.incurences-fees
Finance Charge	expenses:home.incurences-fees
ATM Fee	expenses:home.incurences-fees
Bank Fee	expenses:home.incurences-fees
Trade Commissions	expenses:home.incurences-fees
Life Insurance	expenses:home.incurences-fees
Financial Advisor	expenses:home.incurences-fees
Groceries	expenses:food.groceries
Coffee Shops	expenses:food.coffee
Fast Food	expenses:food.restaurants
Restaurants	expenses:food.restaurants
Alcohol & Bars	expenses:food.bars
Gift	expenses:shopping.gifts
Charity	expenses:misc.charity
Dentist	expenses:wellness.healthcare
Doctor	expenses:wellness.healthcare
Eyecare	expenses:wellness.eyecare
Pharmacy	expenses:wellness.pharmacy
Health Insurance	expenses:wellness.healthcare
Gym	expenses:wellness.healthcare
Sports	expenses:entertainment.sport
Furnishings	expenses:house.fitment
Lawn & Garden	expenses:house.garden
Home Improvement	expenses:house.repairs
Home Services	expenses:home.services
Home Insurance	expenses:home.incurences-fees
Mortgage & Rent	expenses:home.rent
Home Supplies	expenses:house.other
Paycheck	income:salary.other
Returned Purchase	income:refund.other
Bonus	income:salary.other
Interest Income	income:financial.other
Reimbursement	income:refund.other
Rental Income	income:financial.other
Deposit	
Withdrawal	
Dividend & Cap Gains	
Buy	
Sell	
Babysitter & Daycare	expenses:misc.kids
Child Support	expenses:misc.kids
Toys	expenses:misc.kids
Kids Activities	expenses:misc.kids
Allowance	expenses:misc.kids
Baby Supplies	expenses:misc.kids
Loan Payment	expenses:home.mortgage
Loan Insurance	expenses:home.mortgage
Loan Principal	expenses:home.mortgage
Loan Interest	expenses:home.mortgage
Loan Fees and Charges	expenses:home.mortgage
Hair	expenses:wellness.beauty
Spa & Massage	expenses:wellness.healthcare
Laundry	expenses:home.services
Pet Food & Supplies	expenses:misc.pets
Pet Grooming	expenses:misc.pets
Veterinary	expenses:misc.pets
Clothing	expenses:shopping.clothes
Books	expenses:shopping.books
Electronics & Software	expenses:shopping.electronics
Hobbies	expenses:shopping.hobby
Sporting Goods	expenses:entertainment.sport
Federal Tax	
State Tax	
Local Tax	
Sales Tax	
Property Tax	
Credit Card Payment	
Transfer for Cash Spending	
Air Travel	expenses:transport.flights
Hotel	expenses:entertainment.vacation
Rental Car & Taxi	expenses:transport.car
Vacation	expenses:entertainment.vacation
Cash & ATM	expenses:misc.withdrawals
Check	